test_basic_astar
10
8
##########
##   #####
##*# #####
# *   .  #
#  a*??  #
###  #.###
####   ###
##########