heuristic_count
8
9
######
#    #
# ##?###
# .?.  #
## ?* *#
 #  a  #
 # #.###
 #   #
 #####