sokoban_gif
8
8
#######
###   #
# ? # ##
# #  . #
# .  # #
##?#.? #
##a  ###
######